11111111111
1000C000001
10000000001
1000000C001
10C00000C01
10000000001
10C00000001
10000000001
100C0000C01
1P000000C01
10C00AC00E1
11111111111
