11111111111
10000000001
10000000001
10000000001
10000000001
10000000001
10000000001
10000000001
10000000001`
1P0C0C00C01
10C000C00E1
11111111111
