1111111111111111
1000000C00000001
10P0000CE0000001
1000000C00000001
1111111111111111