111111111111111111
100000000000000001
111111111E11100001
111110C00000PC0001
111111111111111111