111111111111111111
10000000000C000001
111111111E11100001
111110010000P00001
111111111111111111
