11111111111111111111
1C0010000100C0001001
11101000010000001001
1000100001111000C001
100C1000010000000001
100000000100C0000101
10001000010000010101
110110PEC000011101C1
10C010000000C0001001
11111111111111111111
