111111111111111111
10P00000001C000001
111111111E11100001
111110011000000001
111111111111111111
