111111111111111111
1000000000000P0001
111111111E11100001
111110C0000C0C0001
111111111111111111