111111111111111111
10000000001C0000P1
111111111E11100001
111110011000000001
111111111111111111
111111111111111111
111111111111111111