11111111111
10C000C00C1
1C00C001001
101C0001101
1C001000001
1P000000001
1000C000C01
100C0000001
10111111101
10C00000001
10000C00001
10000000001
10C00E01001
1000A001001
10000000001
11111111111
