11111111111
10C000C00C1
1C00C0E1001
111C0000111
1C001000001
1P000000001
1000C000C01
100C0000001
11111111101
10000000001
10000C00001
10000000001
10C00A00001
100000000C1
11111111111
