11111111111
10C000C00C1
1C00C001001
111C0000111
1C001000001
1P000000001
1000C000C01
100C0000001
11111111101
10000000001
10000C00001
100000000E1
10C00001001
1000A0010C1
11111111111
