11111111111
100C00P0001
100C00E0001
11111111111
