11111111111
10C000C10C1
1C00C0E1001
111C00001C1
1C001C00001
1P0C0000C01
11111111111
