11111111111111111111
1P000000000000000001
11111111111111111101
1000000C000000000001
11100000000000011101
100000000000E00C0001
10A00000000000000001
11111111111111111111
