11111111111111111111
1C001C0001C0001C1E01
11101111010000101011
1C00100A0111101000C1
10111011010000001111
1000001C0111111000C1
11101111010000101111
1C0000000101000001C1
11111111010111110101
1C1C1000000100000001
10101111111111111101
1000C010001000C00001
1P1010C010C010001C01
11111111111111111111
