1111111111111111111111111111111111
10000000000000000C0000000000000101
1111011111111111100000011111111111
1E00C000000000000P0000C000000000A1
1111111111111111111111111111111111